border_size=1
usage=map

Wo, Wo, Wo, Wo, Ai, Ai, Ai, Ha, Ha, Ha, Ha^Fpa, Ha^Fpa, Ha^Fpa, Aa^Fpa, Aa^Fpa, Aa^Fpa, Aa^Fpa, Aa^Fpa, Aa^Fpa, Aa^Fpa, Aa^Fpa, Ai, Wot, Wot, Ai, Ai, Sm, Aa^Fpa, Wo, Aa^Fpa, Aa^Fpa, Aa^Fpa, Sm, Aa^Fpa, Aa^Fpa, Wo, Aa, Aa, Wo, Gg, Ww^Vm, Aa^Fpa, Aa^Fpa, Aa^Fpa, Sm, Aa^Fpa, Aa^Fpa, Aa^Fpa, Aa^Fpa, Aa^Fpa, Aa^Fpa, Aa^Fpa, Aa^Fpa, Aa^Fpa, Aa^Fpa, Aa^Fpa, Aa^Fpa, Aa^Fpa, Aa^Fpa, Gg
Wo, Wo, Ai, Ai, Ai, Ai, Ha, Ha, Ha^Fma, Ha^Fpa, Ha^Fpa, Ww, Aa^Fpa, Aa^Fpa, Aa^Fpa, Aa^Fpa, Ww, Aa^Vea, Aa^Fpa, Aa^Fpa, Ai, Ai, Ai, Ai, Aa^Fpa, Aa^Fpa, Aa^Fpa, Sm, Sm, Aa^Fpa, Aa^Fpa, Aa^Fpa, Aa^Fpa, Aa^Fpa, Aa^Fpa, Aa^Fpa, Aa, Aa, Aa, Aa^Fma, Aa, Aa^Vca, Ww, Aa^Fpa, Aa^Fpa, Aa^Fpa, Wo, Aa^Fpa, Aa^Fpa, Aa^Fpa, Aa^Fpa, Aa^Fpa, Aa^Fpa, Aa^Fpa, Aa^Fpa, Aa^Fpa, Aa^Fpa, Aa^Fpa, Aa^Fpa, Aa^Fpa
Ai, Ai, Ha, Wwr, Ms, Ha^Vhha, Ha, Ha, Ha^Fma, Ha^Fpa, Ha^Fpa, Ww, Wwg, Aa^Fpa, Aa^Fpa, Aa^Fpa, Wo, Aa^Fpa, Ai, Ai, Ai, Ai, Aa, Aa^Fpa, Aa^Fpa, Aa^Fpa, Aa^Fpa, Aa^Fpa, Aa^Fpa, Aa^Fpa, Aa^Fpa, Wo, Aa^Fpa, Aa^Fpa, Aa^Fpa, Aa^Fpa, Aa^Fpa, Aa, Aa^Fpa, Aa, Aa^Fpa, Aa^Fpa, Aa^Fpa, Wo, Wo, Wo, Wo, Aa^Fpa, Aa^Fpa, Aa^Fpa, Aa^Fpa, Aa^Fpa, Aa^Fpa, Aa^Fpa, Aa^Fpa, Aa^Fpa, Aa^Fpa, Aa^Fpa, Aa^Fpa, Aa^Fpa
Wwr, Ha, Ha^Fpa, Ms, Ms^Xm, Ms, Ha, Ha^Fma, Ha^Fma, Ha^Fpa, Ha^Fpa, Ha^Fpa, Wo, Aa^Fpa, Aa^Fpa, Aa^Fpa, Aa^Fpa, Wo, Ai, Ai, Aa, Aa, Sm, Sm, Aa^Fpa, Aa^Fpa, Aa^Fpa, Aa^Fpa, Wo, Aa^Fpa, Aa^Fpa, Aa^Fpa, Sm, Aa^Fpa, Aa^Fpa, Aa^Fpa, Sm, Aa^Fpa, Sm, Aa^Fpa, Aa^Fpa, Aa^Fpa, Aa^Fpa, Aa^Fpa, Aa^Fpa, Aa^Fpa, Wo, Wo, Wo, Aa^Fpa, Aa^Fpa, Aa^Fpa, Aa^Fpa, Aa^Fpa, Aa^Fpa, Aa^Fpa, Aa^Fpa, Aa^Fpa, Aa^Fpa, Aa^Fpa
Ha, Ha^Fpa, Ms, Ms^Xm, Ms^Xm, Ms, Ha^Fma, Ha^Fma, Ha^Fpa, Ha^Fpa, Ha^Fpa, Aa^Fpa, Aa^Fpa, Wo, Wo, Aa^Fpa, Ai, Ai, Wot, Ai, Sm, Aa, Sm, Sm, Aa^Fpa, Aa^Fpa, Wo, Aa^Fpa, Aa^Fpa, Wo, Wo, Aa^Fpa, Aa^Fpa, Aa^Fpa, Aa^Fpa, Aa^Fpa, Aa^Fpa, Aa^Fpa, Wo, Aa^Fpa, Sm, Sm, Aa^Fpa, Aa^Fpa, Aa^Fpa, Aa^Fpa, Aa^Fpa, Sm, Sm, Wo, Wo, Aa^Fpa, Sm, Aa^Fpa, Aa, Aa, Aa^Fpa, Aa^Fpa, Aa^Fpa, Aa^Fpa
Ha, Ha^Fpa, Ha^Fpa, Ms^Xm, Ms^Xm, Ms, Ha^Fma, Ha^Fma, Ha^Fpa, Ha^Fpa, Aa^Fpa, Aa^Fpa, Aa^Fpa, Aa^Fpa, Rp, Ai, Wot, Wot, Ai, Ai, Aa, Aa, Aa^Fpa, Aa^Fpa, Wo, Aa^Fpa, Wo, Aa^Fpa, Aa^Fpa, Wo, Aa^Fpa, Aa^Fpa, Wo, Aa^Fpa, Aa^Fpa, Aa^Fpa, Aa^Fpa, Wo, Wo, Aa^Fpa, Aa^Fpa, Aa^Fpa, Aa^Fpa, Aa^Fpa, Aa^Fpa, Aa^Fpa, Aa^Fpa, Aa^Fpa, Aa^Fpa, Aa^Fpa, Aa^Fpa, Wo, Sm, Sm, Aa^Fpa, Aa, Aa^Fpa, Aa^Fpa, Wo, Wo
Ha, Ha^Fpa, Ha^Fpa, Ms, Ms, Ha, Ha^Fma, Ha^Fpa, Ha^Fpa, Ha^Fpa, Aa^Fpa, Aa^Fpa, Aa^Fpa, Aa^Fpa, Rp, Ai, Ai, Wot, Ai, Aa, Cha, Aa, Aa^Fma, Aa^Fda, Aa^Fma, Aa^Fpa, Aa^Fpa, Aa^Fpa, Aa^Fpa, Wo, Aa^Fpa, Aa^Fpa, Wo, Wo, Wo, Aa^Fpa, Aa^Fpa, Aa^Fpa, Aa^Fpa, Wo, Aa^Fpa, Aa^Fpa, Aa, Aa, Aa^Fpa, Aa^Fpa, Aa^Fpa, Aa^Fpa, Aa^Fpa, Aa^Fpa, Aa^Fpa, Wo, Ww, Wo, Wo, Wo, Ww, Aa^Voa, Ww, Aa^Fpa
Ha, Ha, Ms^Xm, Ms^Xm, Ha^Fma, Ha^Fma, Ha^Fpa, Ha^Fpa, Ha^Fpa, Aa^Fpa, Aa^Fpa, Aa^Fpa, Aa^Fpa, Aa^Vea, Aa, Rp, Rp, Ai, Ai, Ww^Vm, Rp, Aa, Aa, Aa, Rp, Aa, Aa^Fma, Aa^Fpa, Aa^Fpa, Aa^Fpa, Aa^Fma, Sm, Wo, Wo, Wo, Aa^Fpa, Aa^Fpa, Aa^Fpa, Aa^Fpa, Aa^Fpa, Aa^Fpa, Sm, Wo, Aa^Fpa, Aa^Fpa, Aa^Fpa, Aa^Fpa, Aa^Fpa, Aa^Fpa, Aa^Fpa, Aa^Fpa, Aa^Fpa, Aa^Fpa, Aa^Fpa, Aa^Fpa, Aa^Fpa, Aa^Fpa, Ww, Aa^Fpa, Aa^Fpa
Ms, Ms^Xm, Aa, Ha^Fma, Ha^Fda, Ha^Fma, Ha^Fda, Ha^Fpa, Wo, Wo, Aa^Fpa, Aa^Fpa, Aa^Fma, Aa^Fma, Aa, Aa, Cha, Cha, Aa, Ai, Ww, Rp, Aa, Rp, Aa, Aa^Vha, Ai, Aa^Fda, Ai, Ai, Ai, Sm, Sm, Aa^Fpa, Aa^Fma, Aa^Dr, Sm, Aa^Fpa, Aa^Fpa, Aa^Fpa, Aa^Fpa, Aa^Fpa, Aa^Fpa, Aa^Fpa, Aa^Fpa, Aa^Fpa, Aa^Fpa, Aa^Fpa, Aa^Voa, Aa^Fpa, Aa, Aa, Aa^Fpa, Aa^Fpa, Aa, Aa^Fpa, Aa^Fpa, Aa^Fpa, Aa^Fpa, Aa^Fpa
Ha, Ms, Ha^Fma, Ha^Fda, Aa, Rrc^Vhca, Aa^Fma, Aa^Fma, Wo, Wo, Aa^Fpa, Aa^Fma, Aa^Fma, Aa, Aa, Cha, 3 Kha, Ww^Vm, Ww, Ww, Wo, Ww, Ww, Ai, Ww, Ww, Ww, Ai, Ww^Vm, Cha, Koa, Sm, Aa^Fda, Aa^Fpa, Aa^Voa, Aa^Fpa, Sm, Aa^Fpa, Aa^Fpa, Aa^Fpa, Aa^Fpa, Aa^Fpa, Sm, Aa^Fpa, Aa^Fpa, Aa^Fpa, Aa^Fpa, Aa^Fpa, Aa^Fpa, Aa^Fpa, Aa^Fpa, Aa, Aa, Aa, Aa, Aa, Aa^Fpa, Aa^Fpa, Aa^Fpa, Aa^Fpa
Ha, Ha^Fma, Ha^Fda, Ha^Fda, Aa, Ai, Aa^Fma, Aa^Fpa, Aa^Fpa, Aa^Fma, Wo, Wo, Aa, Aa, Rr, Cha, Ai, Ww, Wo, Wo, Wo, Ww, Ww, Ww^Vm, Cha, Gg, Gd^Fmw, Rp, Sm, Aa^Fma, Aa^Fma, Sm, Aa^Fda, Aa^Fpa, Sm, Aa^Fpa, Aa^Fpa, Aa^Fpa, Aa^Fpa, Aa^Fpa, Aa^Fpa, Aa^Fpa, Wo, Aa^Fpa, Aa^Fpa, Aa^Fpa, Aa^Fpa, Aa^Fpa, Aa^Fpa, Aa^Fpa, Aa^Fpa, Aa^Fpa, Aa^Fpa, Aa, Aa, Aa, Wo, Aa^Fpa, Aa^Fpa, Aa^Fpa
Ha, Ha^Fda, Ha^Fda, Ha^Fda, Ww, Ww, Aa, Aa^Fma, Aa, Aa, Aa, Aa^Fma, Rp, Rp, Ai, Aa, Ai, Wo, Wo, Wo, Ww, Gg, Ww, Gg, Rp, Rp, Rp^Vhcr, Sm, Wot, Aa^Fma, Aa, Aa, Aa, Aa^Fpa, Wo, Rb, Aa^Fda, Aa, Aa, Aa^Fpa, Aa, Aa^Fpa, Aa^Fpa, Wo, Aa^Fpa, Aa^Fpa, Aa, Aa, Aa, Aa, Aa, Aa, Aa, Aa, Aa, Aa, Aa, Aa^Fpa, Aa, Aa
Ai, Ha^Fda, Ai, Ww, Ww, Ww, Ww^Vm, Aa, Aa, Aa, Aa^Fda, Aa^Fma, Rp, Ww, Wo, Ww, Khw, Ww, Wo, Wo, Ww, Gg, Ww, Ss, Rp, Gg, Gd^Fmw, Gd^Fmw, Wot, Coa^Dr, Rb, Aa^Fma, Aa, Aa^Fma, Aa^Voa, Rb, Aa^Fpa, Aa^Fma, Aa^Fda, Aa, Aa, Aa, Ai, Aa^Fma, Wo, Aa, Wo, Aa, Aa, Aa, Aa, Aa, Aa, Aa, Aa, Aa, Aa, Aa, Aa, Aa
Ww, Ai, Ww, Ww, Rrc, Ww, Ww, Aa, Aa, Sm, Aa^Fda, Aa^Fma, Rp, Ww, Wo, Ww, Chw, Ww, Ww, Ww, Gg, Ww, Ww, Ww^Vm, Kh, Rp, Gd^Fmw, Ss, Ss, Koa, Aa^Fma, Rb, Aa, Aa, Aa, Aa^Fma, Aa^Fpa, Aa^Fpa, Aa, Aa^Fma, Aa, Aa, Rb, Ai, Aa^Voa, Wo, Aa, Wo, Wo, Coa, Wo, Aa, Aa^Fma, Aa, Aa, Aa, Aa, Aa, Aa, Aa
Ww, Rrc, Rrc, Rr^Vhc, Ww, Ww, Ww, Sm, Rp, Aa, Rp, Cha, Ww^Vm, Ww, Wo, Wo, Wo, Ww, Ww, Gg, Gg^Gvs, Gg, Gg, Chw, Wo, Wo, Wo, Gd^Fmw, Gll^Fp, Sm, Gll^Fp, Aa^Fma, Aa^Fda, Coa, Aa^Fda, Aa^Fpa, Aa, Aa^Fda, Aa^Fpa, Aa^Fpa, Coa, Aa, Aa, Rb, Aa^Fpa, Rb, Aa^Fpa, Aa^Fpa, Aa^Fpa, Ww, Aa, Wo, Wo, Aa, Aa, Aa, Aa, Aa, Aa^Fpa, Aa^Fpa
Gg, Gg, Gg, Rrc, Gg, Ww, Ww, Aa, Rp, Rp, Aa^Fda, Aa^Fda, Ww, Wo, Wo, Wo, Wo, Wo, Wo, Gg^Dr, Rp, Gd^Fmw, Gll^Fmf, Gll^Fmf, Gll^Fmf, Gd^Fmw, Gd^Fmw, Wo, Wo, Gd^Fmw, Aa^Voa, Gll^Fp, Gd^Fmw, Aa^Fma, Wo, Wo, Aa^Fma, Aa^Fpa, Aa^Fpa, Aa, Aa, Aa, Aa, Aa, Aa^Fpa, Rb, Coa, Aa^Fpa, Aa^Fpa, Aa^Fpa, Aa, Aa, Aa^Fpa, Wo, Wo, Aa, Aa^Fpa, Aa^Fpa, Aa^Fpa, Aa^Fpa
Gg, Gg, Gg, Rrc, Ww, Ww, Ww^Bsb/, Rrc^Vhca, Aa, Ww, Ww, Ww, Wo, Wo, Wo, Wo, Wo, Wo, Ww, Wwr, Wo, Wo, Wo, Gs^Fdw, Rp, Gll^Fmf, Gg, Rp^Vhcr, Gd^Fmw, Wo, Ww, Gd^Fmw, Wo, Wo, Aa, Aa, Wo, Aa, Wo, Aa, Aa^Fma, Aa^Fpa, Aa^Fpa, Aa^Fma, Coa, 5 Koa, Coa, Aa, Aa, Aa^Fpa, Aa^Dr, Aa^Voa, Aa^Fpa, Aa^Fpa, Wo, Ai, Wo, Wo, Wo, Aa^Fpa
Wwr, Gg, Gg, Rrc, Cha, Kha, Ww^Vm, Ww, Ww, Ww, Wo, Wo, Wo, Wo, Ww, Wo, Wo, Ww, Kh, Ss^Vm, Gg, Gg, Gg^Gvs, Wo, Chw, Chs, Ss, Gg, Gg, Gd^Fmw, Gll^Fmf, Wo, Gll^Fmf, Chw, Gll^Fp, Ai, Aa^Vha, Wo, Aa, Aa, Aa^Fpa, Aa^Fpa, Aa^Fpa, Aa^Fda, Aa^Fma, Coa, Aa^Fma, Aa^Fpa, Aa^Fpa, Aa^Fpa, Aa^Fpa, Aa, Aa^Fpa, Aa^Fpa, Ww, Coa, Aa^Fpa, Aa^Fpa, Aa, Wo
Wwr, Gg, Gs^Dr, Wwr, Ww^Vm, Chw, Ww, Ww, Ww, Chr^Dr, Ww, Wo, Ww, Ww, Ch, Ww^Vm, Wwr, Gg, Rrc, Gg, Gll^Fmf, Gg, Gg, Wo, Gg, Kv, Gg, Gg, Wo, Gll^Fmf, Gd^Fmw, Gll^Fmf, Gd^Fmw, Gg, Wo, Wo, Aa, Rb, Aa, Aa^Fpa, Aa^Fpa, Aa^Fpa, Aa^Fpa, Aa^Fda, Rb, Aa, Aa^Fpa, Aa^Fpa, Aa^Fpa, Aa, Aa^Fpa, Aa, Aa, Wo, Aa^Fpa, Aa, Aa, Aa^Fpa, Aa^Fpa, Aa
Ww^Vm, Gg, Gg, Gg^Gvs, Chw, Ww, Gg, Gg, Gg, Ww, Rrc, Ww, Rrc, Rrc, Kh, Chw, Wo, Ww^Vm, Rrc, Gg, Wo, Gll^Fmf, Gg, Wo, Wo, Wwf, Wo, Wo, Ww, Gg, Re, Gll^Fmf, Gd^Fmw, Gll^Fmf, Wo, Rb, Aa, Aa, Aa, Rb, Coa, Aa, Aa, Aa, Rb, Aa^Fpa, Aa, Aa, Aa^Fma, Ai, Wo, Aa, Wo, Wo, Aa^Fpa, Aa, Aa, Aa^Fpa, Aa^Fpa, Aa
Wo, Rrc, Rr^Vhc, Rrc, Gg, Rrc, Rrc, Gs^Fds, Rrc, Ww^Vm, Wo, Rrc, Gd^Fdf, Gg, Gg^Gvs, Gg, Wo, Chr^Dr, Rr, Gg, Gg, Gg, Ss, Gg, Re, Chs, Khs, Sm, Re, Gs^Vl, Gg, Gg, Gll^Fmf, Gs^Vl, Wo, Rb, Rb, Aa^Fma, Aa^Voa, Aa^Fda, Aa, Aa, Aa, Rb, Aa, Aa^Voa, Aa^Fda, Aa^Fma, Gll^Fp, Ai, Aa, Wo, Aa, Aa, Gll^Fp, Aa, Gll^Fp, Aa, Gll^Fp, Aa
Gg, Wo, Wo^Bsb|, Gg^Gvs, Wo, Gg, Gg, Rrc, Gg^Gvs, Gg, Wo, Gg^Gvs, Gg^Gvs, Gg, Chw, Wo^Bw/, Rr^Vhc, Gg^Gvs, Rr, Gg, Re, Re, Re, Re, Gg, Gg, Gg, Gg, Wog, Gg, Gg, Gll^Fmf, Gd^Fmw, Gg, Wo, Gll^Fp, Gg, Rb, Gll^Fp, Rb, Rb, Rb, Gg, Aa, Gg, Gg^Dr, Gg, Gll^Fp, Gll^Fp, Aa, Gg, Aa^Vca, Re, Gg, Gll^Fp, Gll^Fp, Gg, Gg, Gll^Fp, Gg
Gg, Rrc, Chr, Wo, Gg, Wo, Gg, Ch, Kh, Rrc, Wo, Rrc, Rr, Gg, Rr, Wo, Wo, Gg, Wo^Bw|, Re, Wo, Wo, Wo, Gg, Gd^Fdf, Ss, Ss, Wwg, Ss, Wog, Wog, Gg, Gs^Fdw, Gd^Fmw, Wo, Gg, Co, Rb, Gll^Fp, Gg, Gg, Gg, Gg, Gs, Gg, Ww, Gg, Gg, Gll^Fp, Gll^Fp, Gg, Gll^Fp, Gg, Re, Re, Gg^Es, Gll^Fp, Gll^Fp, Gg, Gg
Wo, Gg, Gg, Ch, Gg, Wo, Wo, Gg, Rrc, Gg, Gg, Wo, Gg^Gvs, Gs^Vh, Rr, Gg^Gvs, Rr, Wo, Ch, Wo, Wo, Gd^Fdf, Gg, Wo, Ss^Vhs, Ss, Ss, Ss, Ss, Ss, Ss, Wog, Wog, Gg, Wo, Gd^Fmw, Gd^Fmw, Gg, Rb, Gg, Gg, Gg, Gg, Gg, Gg, Ww, Gg, Gg, Gg^Fet, Gg, Gg^Es, Gll^Fp, Co, Gg^Fet, Gg, Re, Gg, Gg, Gg, Gg
Gs^Fds, Wo, Gg, Rrc, Rrc, Gg, Wo, Gg^Gvs, Gg, Rrc, Hh, Wo, Wo, Rr, Gg^Gvs, Rr, Gg, Ch, Ch, 4 Kh, Wo^Bw\, Gg, Gg, Ww^Ewf, Wog, Ss, Sm, Ss, Sm, Ss, Ss, Ss, Ss^Vm, Gs^Fdw, Wo, Gd^Vo, Gg, Rb, Gg, Rb, Rb, Gg, Gg, Gg, Gg, Ww, Gg, Gg^Es, Gg, Gll^Fp, Gg^Efm, Gd^Fmw, Gg, Gg, Gg, Gd^Vo, Gg, Gg, Gll^Fp, Gll^Fp
Gs^Fds, Wo, Gg, Gg, Gg, Rrc, Rp^Vhcr, Wo, Wo, Hh^Fms, Hh^Fms, Hh, Rr^Vhc, Wo^Bw/, Wo, Gg^Gvs, Gg, Gg^Gvs, Gg, Ch, Wo, Gs^Vh, Cv^Dr, Sm, Sm, Wwg, Ss, Ss^Vhs, Ss, Gs^Fms, Gd^Fmw, Ss, Gs, Wwg, Wo, Gs^Fms, Re, Gs, Gs, Gd^Fmw, Gg, Rb, Gd^Vo, Gg, Gd^Fmw, Wo, Ww, Co, Gd^Fmw, Gd^Fmw, Gs, Gs, Gs, Gg, Gg^Efm, Gg, Gs, Gg, Gg, Gg
Gg, Gg, Gg, Gg, Gg, Gg, Gs^Fds, Rrc, Wo, Wo, Rrc, Hh, Hh, Hh, Rrc, Wo, Gg, Gg^Gvs, Rr, Rr, Gg, Wo, Re, Gg, Gs, Sm, Ss, Ss, Ss, Gd^Fmw, Re, Gs^Fdw, Co, Co, Wwf, Re, Gs, Gs, Gs^Es, Gs, Gs, Gs, Re, Gs, Gs^Es, Gs^Fdw, Wo, Gs^Es, Gs, Gs, Gs, Gs, Gs, Gs, Gs, Gs, Gs, Gg^Fet, Gs, Gg
Wo, Wo, Wo, Wo, Gg^Gvs, Gg, Gs^Fds, Gs^Fds, Ww^Bsb/, Khr, Chr, Rrc, Hh^Fms, Hh, Rrc, Ww, Kh, Ch, Rp, Gg, Ww, Ww, Re, Gs, Re, Re, Re, Ss, Re, Re, Gs, Co, Gd^Fmw, Ko, Wo, Re, Gs, Gs, Gs, Gs, Gg^Dr, Co^Dr, Re^Es, Gs, Gs, Gg^Dr, Gs, Wo, Wo, Gs, Gs, Gs, Gs, Gs, Gs, Gs, Gs, Gs, Gs, Gg
Gg, Gg, Gg, Gg, Gg, Gg, Gg^Gvs, Gs^Dr, Hh^Fms, Wo, Hh, Hh, Hh^Fp, Hh^Fms, Hh, Rrc, Hh, Ch, Hh, Rr, Hh^Fp, Re, Hh^Fms, Gg^Ve, Gd^Fdf, Gs^Gvs, Gs, Chs, Gs, Gs, Gs, Gd^Fmw, Re, Co, Wo, Gd^Vo, Gs, Gs, Gg^Fet, Gs, Gs, Gs, Re, Gd^Fmw, Gs, Gs^Efm, Gs, Gs, Gs, Wo, Wo, Gs, Gd^Fmw, Gs, Wo, Gs, Gs, Gs, Gd, Gd
Gg, Gg, Gg, Gg, Gg, Gg, Rrc, Rrc, Hh^Fms, Wo, Hh^Fms, Hh, Hh, Hh, Hh, Hh^Fms, Hh, Hh, Hh, Hh, Hh, Hh^Fp, Hh, Hh^Fms, Gs^Gvs, Gs^Gvs, Gs, Ww, Gs^Gvs, Gs^Gvs, Re, Re, Gs^Fdw, Re, Re, Wo, Wo, Gs, Gs, Gs, Gs^Efm, Gll^Fp, Gd^Vo, Ww, Ww, Gs, Gs, Gs, Gs, Gs^Efm, Gs, Wo, Wo, Wo, Gs, Wo, Gd, Gd, Wwg, Wwg
Gg, Gg, Wo, Wo, Wo, Rrc, Wo, Gg, Wo^Bsb|, Hhd^Vhhr, Hh, Hh^Dr, Gd^Vhr, Gs, Gg, Hh, Gs, Hh, Re, Ss^Vhs, Gs, Hh, Hh, Hh^Fp, Hh, Gs, Gs, Wo, Ww, Re, Gs, Gs, Gs, Gd^Fmw, Gd^Vhr, Wo, Wo, Gs, Gs, Gs, Gs, Gd^Fmw, Gd^Fmw, Gll^Fmf, Gs, Wo, Wo, Gs, Gs, Gd^Fmw, Gs^Fdw, Gs, Gs, Gs, Gd, Wo, Gd, Re^Vct, Wwg, Gd
Rrc, Rrc, Rrc, Rp^Vhcr, Hh, Wo, Hh^Fp, Wo, Cud, Wo, Gs, Gs, Gs, Gs, Gs, Gs, Rr, Cv, Re, Ww, Gs, Gs, Hh, Hh^Fms, Cdr, Chr, Rr, Gs, Gd^Vhr, Wo, Wo, Gs^Gvs, Gs, Gs^Gvs, Gg^Fet, Gs, Gs, Wo, Wo, Gs, Gs, Gs, Gd, Gd, Gd, Gs, Gd, Wo, Gd, Gs, Gd, Gs, Gd, Gd, Gd, Wwg, Ss, Ss, Ss, Wwg
Hh, Hh, Hh^Fp, Hh, Mm, Wo, Uu^Vud, Hh^Fp, 7 Kud, Wo, Wo, Gs, Wo, Cv, Kv, Rr, Gs, Gs, Wo, Ww, Re, Gs^Vh, Gs^Fms, Hh^Fms, Hhd, Ww, Wo, Rr, Gs, Gs^Gvs, Gs^Gvs, Wo, Wo, Gs, Gs, Gs, Cea, Gs^Efm, Wo, Wo, Gd, Gd, Gd, Gd, Gd, Gd, Gd, Ww, Wo, Gd, Gd, Gd, Gd, Gd, Wog, Wwg, Ss, Ss, Ss, Ss
Mm^Xm, Mm, Ha^Vhha, Wo, Mm^Xm, Mm^Xm, Mm^Xm, Mm^Xm, Cud, Cud, Hh, Wo, Rr^Vhc, Wo^Bsb/, Gg, Gs, Gs, Wo, Gs, Gs, Re, Gs, Cdr, Hhd^Fdw, Hhd^Fdw, Hhd^Dr, Wo, Rr, Gg^Fet, Gs, Gs, Gs, Gs, Wo, Gd, Gd^Wm, 2 Kea, Wo, Gd, Gd, Gd, Gd, Gd, Gd, Gs^Wm, Gd, Gd, Gd, Wog, Kea, Cea, Gd, Gd, Gd, Wog, Gd, Ss, Ss, Ss, Ss
Mm^Xm, Ms^Xm, Mm, Hh, Hh^Fp, Mm, Mm, Cud, Ww, Hh, Hh, Wo, Gs^Es, Wo, Gs, Gs, Wo, Wo, Gs, Gs, Hhd, Re, Gs^Fms, Kdr, Re, Hhd^Fdw, Hhd^Fdw, Wo, Wo, Gs, Gd, Gd, Re^Vct, Wo, Wo, Wo, Wo, Wo, Gd, Gd, Gd, Gd, Gd, Gd, Wwt, Wwt, Chs^Dr, Wog, Gd, Wog, Wog, Gd, Wog, Wog, Gd, Gd, Ss, Ss, Ss, Ss
Hh, Mm^Xm, Hh^Fp, Hh, Gs, Hh^Fp, Hh, Cud, Hh, Wo, Wo, Gs, Chs, Wo, Wo, Gs, Ww, Gs, Chr, Gs, Hhd^Fdw, Hhd^Fdw, Hhd^Fdw, Gs^Fms, Hhd, Re, Hhd^Vhhr, Hhd^Fdw, Wo, Gd, Wo, Wo, Wwr, Wwr, Gd, Gd, Gd, Gd, Ket, Gd, Wwt, Wwt, Wwt, Wwt, Wwg, Re^Vct, Gd, Gd, Gd, Gd, Gd, Wog, Gd, Gd, Gd, Gs^Fdw, Gd, Ss, Ss, Ss
Wo, Hh, Chw, Rr, Rr, Rr, Rr, Hh, Hh^Vhh, Gs^Fms, Gs^Fms, Wo, Wo, Ww, Rr, Ww, Rr, Rp^Vhcr, Gs, Gs, Hhd, Hhd, Mm, Mm, Mm, Mm, Mm, Mm, Mm, Wo, Gd, Gd, Ww^Vm, Wwt, Wwt, Wwt, Wwt, Wwt, Ce, Wwr, Wwt, Wot, Wwt, Wog, Wwg, Wwg, Ss, Gd, Gd, Gd, Gd, Gd, Gd, Gd, Gd, Gd^Fmw, Gd, Ss, Ss, Ss
Gs, Wo, Rr, Ww^Vm, Wwt, Gs, Hhd, Ww, Wo, Wo, Wo, Hhd, Hhd, Wo, Wo, Rr, Gs, Gs, Gs, Gs, Hhd^Fdw, Mm, Hhd^Fdw, Hhd^Fdw, Gd^Wm, Hhd^Fdw, Hhd^Fdw, Mm, Hhd, Hhd, Wwr, Wwt, Wot, Wot, Wot, Wot, Wwt, Gd, Ce, Gd, Gd, Wwt, Re^Vct, Wwg, Wwg, Ss, Ss, Ss, Gd, Gd, Gd, Gd, Gd, Gs^Fdw, Gd, Gd, Gd, Gd, Gd, Ss
Gs, Gs, Rr, Wwt, Wot, Wwr, Wwr, Gd, Hhd^Fdw, Hhd^Fdw, Hhd, Wo, Wo, Wo, Cdr, Wo^Bw|, Wo, Gs, Gs, Hhd, Hhd, Hhd^Fdw, Gd, Gd, Rd, Gd, Wo, Wwt, Wo, Wwr, Wot, Wot, Wot, Wot, Wot, Wot, Wot, Wwt, 1 Ke, Ce, Wwt, Gd, Wwg, Ss^Vm, Ss, Ss, Ss, Ss, Gs^Fdw, Gd, Gd, Re^Vct, Gd, Gd, Gd, Gd, Gd, Gd, Gd, Gd
Hhd, Gs, Hhd, Wwt, Wwt, Wot, Wwt, Gs, Gd, Hhd^Fdw, Rd, Hhd, Hhd, Wo, Hhd, Kdr, Hhd^Fdw, Wo, Wo, Hhd, Hhd, Gd, Gd, Gd^Vhr, Re, Gd^Gvs, Wo, Gd, Gd, Wwt, Wot, Wot, Wot, Wot, Wot, Wot, Wot, Ww^Vm, Wwt, Wwt, Wot, Wwt, Wog, Wwg, Wwg, Ss, Ss, Ss, Gg^Wm, Gs^Fdw, Gs^Fdw, Gd, Gd, Gd, Gs^Fdw, Gd, Gd, Gg^Wm, Gd, Gd
Hhd, Hhd, Hhd, Hhd, Wwt, Wot, Wot, Wwr, Wwr, Hhd, Rd, Cdr, Hhd, Wo, Hhd, Gd, Gd, Hhd^Fdw, Hhd, Wo, Wo, Wo, Wo, Wo, Wo, Wo^Bw\, Cdr, Gd, Gd, Wwt, Wot, Wot, Wot, Wot, Wot, Wot, Wot, Wot, Wot, Wot, Wot, Wot, Wot, Wog, Wog, Wwg, Wwg, Hd^Edp, Hd^Edp, Hd^Edp, Md, Hd^Edp, Hd, Gs^Fdw, Hd^Edp, Gs^Fdw, Hd, Gs^Fdw, Gs^Fdw, Re^Vct
Hhd, Hhd, Hhd, Hhd, Md, Wwt, Wot, Wot, Wot, Wwr, Wwr, Rd, Hhd, Wo, Hhd^Fdw, Hhd^Fdw, Gd, Hhd^Fdw, Hhd, Rd, Hhd, Gd, Hhd, Gd, Re, Gd^Gvs, Hhd^Fdw, Gd^Gvs, Ww^Vm, Wwt, Wot, Wot, Wot, Wot, Wot, Wot, Wot, Wot, Wot, Wot, Wot, Wot, Wot, Wot, Wot, Wot, Wot, Wwt, Wwt, Md, Hd, Md, Md^Xm, Md, Md, Md^Xm, Md, Hd^Edp, Wot, Hd
Hhd, Hhd, Hhd, Md, Md, Wwt, Wot, Wot, Wot, Wot, Wwt, Hhd, Chw, Wo, Hhd, Hhd, Rd, Hhd^Fdw, Hhd^Fdw, Hhd^Fdw, Rd, Gd, Hhd, Hhd, Rd, Hhd^Gvs, Hhd, Hhd, Wwt, Wot, Wot, Wot, Wot, Wot, Wot, Wot, Wot, Wot, Wot, Wot, Wot, Wot, Wot, Wot, Wot, Wot, Wot, Wot, Wot, Wwt, Dd, Dd, Dd, Md, Md, Md^Xm, Hd^Edp, Md, Md^Xm, Md
Wwt, Hhd, Cv, Md, Md, Wwt, Wwt, Wot, Wot, Wot, Wot, Ww^Vm, Wwt, Mm, Mm, Gg^Wm, Hhd, Hhd^Fdw, Gd, Hhd, Gd^Vhr, Hhd^Fdw, Mm, Hhd, Rd, Hhd, Ds, Wwt, Wot, Wot, Wot, Wot, Wot, Wot, Wot, Wot, Wwt, Wwt, Ww^Vm, Wwt, Wwt, Wot, Wot, Wot, Wot, Wot, Wot, Wot, Wot, Wwt, Wwt, Dd^Vdt, Dd, Md^Xm, Md^Xm, Md, Hd, Hd^Edp, Hd, Hd
Wot, Wwt, Kv, Cv, Md, Hhd, Wwt, Wwt, Wwt, Wot, Wot, Wot, Wot, Wwt, Hhd, Mm, Mm, Hhd, Gd, Hhd, Mm, Mm, Mm, Mm, Dd^Vda, Dd, Ds, Wwt, Wwt, Wot, Wot, Wot, Wot, Wot, Wwt, Wwt, Ds, Hd^Edp, Md, Cdr, Md, Wwt, Wwt, Wot, Wwt, Wot, Wwt, Wot, Wwt, Wwt, Md, Md, Md, Md^Xm, Md, Md^Xm, Md, Hd, Hd, Hd
Wot, Wwt, Wwt, Cv, Md, Rr, Rr, Hhd, Wwt, Wot, Wot, Wot, Wot, Wwt, Rd, Mm, Mm, Hhd, Hhd, Hhd^Fdw, Hhd, Mm, Mm, Mm, Hd, Rd, Cd, Cd, Kd, Wwt, Wwt, Wot, Wwt, Wwt, Hd^Edp, Dd, Hd, Md, Md, Md, Md, Md, Ds, Ww, Ds, Wwt, Md, Ww^Vm, Md, Md, Hd^Edp, Hd, Hd, Hd, Hd, Md, Md^Xm, Md, Md, Hd
Wot, Wot, Wot, Wwt, Rr^Vhc, Md, Rr, Hhd, Hhd, Wwt, Wwt, Wot, Wot, Wwt, Dd^Vda, Hhd, Mm, Mm, Gd, Rd, Rd, Hhd, Wwt, Mm, Mm, Ds, Wot, Ww^Vm, Wwt, Ww^Bsb\, 6 Kd, Ww, Ds, Ds, Md, Hd^Edp, Hd, Hd, Hd, Hd, Hd, Hd^Edp, Wot, Wot, Hd^Edp, Md, Ds, Cd, Md, Hd^Edp, Hd^Edp, Hd, Hd, Hd, Hd, Hd, Dd, Md^Xm, Md^Xm, Md
Wot, Wot, Wot, Wwt, Wwt, Md, Hhd, Rr, Rr, Cv, Gs, Wwt, Wwt, Wwt, Hhd, Mm, Hhd, Hhd, Rd, Wwt, Hhd, Wwr, Wot, Wwt, Wwr, Wwt, Ds, Wwt, Ds, Wwt, Cd, Cd, Rd, Hd, Md, Md, Hd, Dd, Rd, Dd^Dc, Dd, Hd^Edp, Wot, Dd^Vda, Ds, Ds, Wot, Dd, Md, Md, Hd, Hd, Hd, Hd, Hd, Hd, Md, Md, Hd, Md
Wot, Wot, Wot, Wot, Wot, Wwt, Hhd, Hhd, Md, Ww^Vm, Wwt, Gs, Wwt, Wwt, Mm, Mm, Hhd, Hhd, Hhd, Ww^Vm, Wwt, Wwt, Wot, Wot, Wwr, Ds, Hd, Hd, Dd^Vda, Md, Md, Hd, Hd, Rd, Rd, Hd, Rd, Rd, Dd, Rd, Kdr, Hd^Edp, Dd^Do, Wot, Wwt, Wot, Hd^Edp, Hd^Edp, Hd, Md, Hd, Hd, Dd, Hd, Hd, Md, Dd, Hd, Hd, Hd
Wot, Wot, Wot, Wot, Wot, Wwt, Wwt, Md, Md, Wwt, Wot, Wwt, Wot, Wwt, Wwr, Mm, Mm, Hhd, Hhd, Wwt, Wot, Wot, Wot, Wot, Wwt, Hd, Hd, Hd^Edp, Hd^Edp, Hd^Edp, Md, Hd, Dd, Hd, Dd, Rd, Hd, Hd, Hd, Dd, Dd, Cdr, Dd^Gvs, Ds, Hd, Hd^Edp, Hd, Hd^Edp, Hd, Hd, Hd, Hd^Edp, Dd^Edp, Hd^Edp, Hd, Md, Md, Hd, Hd, Hd
Wot, Wot, Wot, Wot, Wot, Wot, Wwt, Hhd, Hhd, Wwt, Wot, Wot, Wot, Wot, Wwt, Mm, Mm, Mm, Hhd, Wwt, Wot, Wot, Wot, Wot, Wwt, Dd, Hd, Dd, Dd, Hd, Hd, Hd, Hd, Dd, Dd, Dd, Dd, Hd, Dd, Hd, Dd^Edpp, Dd, Hd, Hd, Hd, Hd, Md, Hd, Md, Hd, Hd, Dd, Dd, Hd^Edp, Hd^Edp, Md, Md, Hd, Hd, Hd
Wot, Wot, Wot, Wot, Wot, Wot, Wwt, Hhd, Wwt, Wwt, Wot, Wot, Wot, Wot, Wot, Wwr, Wwt, Mm, Gs^Wm, Wwr, Wot, Wot, Wot, Wot, Wot, Wwt, Hd, Hd^Edp, Hd^Edp, Hd, Dd, Dd, Hd, Hd, Hd, Wot, Dd, Dd, Dd, Dd, Hd, Hd, Hd, Hd, Hd, Gg^Wm, Md, Md, Md, Hd, Dd, Dd^Dc, Dd, Dd, Dd, Dd, Dd, Md, Hd, Hd
